############################
#    # #        #          #
# #  # # ###### # #### ### #
# #  # # #    # # ###  #   #
# #  ### # ## # # ##  ## ###
# #      # ## # # ## ###   #
########## ## # # ## ##### #
#          ## #   ## #   # #
# ########### ######   # # #
#          ##      ##### # #
########## #######       # #
#                ####### ###
# ##############  #    #   #
# #   # #      #    ## ### #
# # # # # #### #######   # #
# # # # #  ###    #      # #
# # # #  #  ##### # ###### #
#   #    ##     #   #      #
####### ####### ####### ## #
#     #    #  #   #   # #  #
# ### #### #  # # # # # # ##
#   #    # #  # # # # # ####
### ###  # #  # # # # #    #
# #   #  # #  # # # # #### #
#  ## #  # #  # # # #    # #
##### #  # #  # # # #### # #
      #    #    #      #   #
############################