############################
#M             #           #
#              #           #
#              #           #
#####          #           #
#              #           #
#              #           #
#             #           #
#              #           #
#       ########           #
#          #               #
#          #      #        #
##         #      #        #
#          #      #        #
#                 #        #
#                 #        #
###################        #
#                          #
#                          #
###################        #
#                          #
#                          #
#                          #
#                          #
#                          #
#                          #
#                         M#
############################